WWWWWWWWWWWWWWW
WP    WYYYYYYYW
WWW WWWYYYYYYYW
WRRRRRRRRRRRRRW
WBRRRRRRRRRRRRW
WRRRRRRRRRRRRRW
WRRRRRRRRRRRRRW
WBRRRRRRRRRRRRW
WBRRRRRRRRRRRRW
WRRRRRRRRRRRRRW
WYYYYYYYYYYYYYW
WYYYYYYYYYYYYGW
WWWWWWWWWWWWWWW